                     :+*===============*+-                               
               -+===========================*:                           
            :==================================*-                        
          *=======================================-                      
        *==========================================:                     
      +=============================================:                    
     ===============================================*                    
   -===================*:        :===================                    
   ==================*             *================*                    
  *=================+              :================:                    
 -==================               *===============+                     
 *=================+              +=========**++::-                      
 ==================*             :++**===========-                       
-=======**++::--                ===============*                         
                              :===============+                          
                             *===============:                           
                           :================-                            
                          *================-            :===============-
                        :================*             +===============  
                       *================*             *==============*   
                     :=================+       --:++*===============:    
                    *==============================================-     
                  :===============================================       
                 *==============================================*        
               -===============================================+         
              *===============================================:          
            -================================================-           
           +================**++:--        +===============*             
         -==*++::-                        *===============+              
                                        -===========*+::-                
										