
 -#@@@@@@@@@@@@@@@@@@@@@@@@@@@@@@+            #@@@@@@@@@@@@@@@@@@@@@@@@@@@@@@=-
 +@@@@@@@@##############@@@@@@@@@=-          -@@@@@@@@##=========#==#@@@@@@@@#+
 +@@@@@@@#*-            -=@@@@@@@=:          -@@@@@@@@*-             :#@@@@@@#+
  ---------             -#@@@@@@@=:          -@@@@@@@@+              -#@@@@@@#+
 -@@@@@@@@@@@@@@@@@@@@@@@@@@@@@@@=:          -@@@@@@@@+              -@@@@@@@#+
 +@@@@@@@@@@@@@@@@@@@@@@@@#@#@@##*-          -@@@@@@@@+              -@@@#@@@#+
 +@@@@@@@#*:---------------------     =@#+   -@@@@@@@@+              :@@@@#@@#+
 +@@@@@@@##############@@#@@#@@@@#===@@@@@#===@@@@@@@@@@@@@@@@@@#####@@@@@@@@#+
 :@@@@@@@@@@@@@@@@@@@@@@@@@@@@@@@@@@@@@@@@@@@@@@@@@@@@@@@@@@@@@@@@@@@@@#@@@##=+
 