.#%(          #&.#.* %&%*.                    *.,*(*/.,               
//*,*     %(( #  &, (&& ,//*/             &&,./ ///// .,. .,            
/(%&%    .(..,##%%%%,&&  , .&%&        /#*,....&.*/ .  ,*  (%,          
   /,   (,#&,* ,( , * . *  ./&%%(     , ,,  #%.&///*.,.  %&(. &         
  ,/     ,,*/  ,,,., * . . .*& &(    .  ,*.*//**       ,.#(.  ##        
         .* .%,,&      ,,  (/,. ,.      *.*/((/         ... . ..        
      ./,,**/,,         ..( .,  ,    ,  *, ,,,,                         
       ,*...*. *        /    /.  .   *.,#&..,.*                         
       / **/,,**        ,//**   ,(     ,,.  * ,                         
      ,..,,,,,          .*%&&( , #    * *.( ,(.,/(.  ,,  ,            
      *#.,( / .,       ##(&%&./ /*    ,.    * #((& (/.  ,,%& (.         
      ,/(*(,.(/...,,(,,,/** **../    ****/& * %&&%., *.. ,#%,&/.        
       *# #   , .#. . / #,*.**  ,*     ,* & * *  / . /.,.,,,, //        
        *   #    .,.,/*((*/.,,.#(/   . ,  %** ..,, //# .. . ,,,*        
        * *(,((,.*/.  &&.,/*/**#%    ,/*  *. ,*       ... ,,*,,,        
          ./**,*.//.*,*# *,*&. %#    /**,,/, //       .***,,,*.*        
                        **.   (,/    *, ((,,* *       # #(# *,/,        
                        ,,//* *.,    %* . / ,,#        .... ,##,        
                          . (##*(*   *(./.#*,,%       *,*(/..,,,        
      ./**./(.*,.       .,. (//(&,     #%  ,  .      ***  , .,,,        
       ./&(.,  ,      (%%.&,((( *       , ,        .(,,#.% .*#*.        
       /*,,,, &&&,(#(/*  (#//. .,      / . ./***/ ,  ((*  ,,. .         
        .*,,(. /  #(  / /,/*(        .##  ,**// */( .,   /,%          
          #.( *  * /. /*,  /,            (*#,( & /* /.**  ...           
              . *,,**/&                      . %%%# *.                
                                                                       		  
