   .........                                .%%%%%%%%%%%%%%%%                
###%##%%%%%%%%%%,                            .*#%%%%%%%%%%%%%                
  .##%%%(  #%%%#%*            %%%%%%%%%%%%%%%#   #%%%%%**%%%%                
   *%%%%(   %#####             ,#%%%%%%%%%%%%%   /%%%%%  (%%% .%%%%%%%%%%%   
    %%%%(   #####(*%%%%%%%%%%     %#%%%(  %%%#   *%%%%%      %%%%#    #%%%   
    %####   ###%% %%%%%%%%%%%#    ###%%(  %%%(   *%%%%%  %% %%%%%      %%%   
    %%%%%(%%%%%%.    %%%%%%%%%    #%%%%# /#/     /%%%%%#%%% %%%%%      %%%   
    %%%%%%%%%%*     .%%%*,%%%%    %%%%%%.%%#     /%%%%%%%%% *%%%%%           
    %%%%% (%%%%.    /%%%  %%%%*   %%%%%%%%%#     /%%%%%  %%  ###%%%#         
    %%%%%  %%%%%    %%%#  #%%%%   %%%%%* %%#     /%%%%%  ., ,%% %%%%%%%      
   .%%%%#   %%%%%  ,%%%.  *%%%%   %%%%%* /%( .*, /%%%%%     %%% %%%%%%%%%.   
   (%%%%#   #%%%%% %%##%%%%%%%%.  %%%%%*     %%% %%%%%%%%%%%%%%   /%%%%%%%*  
 (#%%%%####, %%%%#( (##(//%%%%%( .%%%%%%   .%% %%%%%%%%%%%%...       (%%%%%  
             ,####### #    %%%/*%%%%%%%%%%%%%%              %%*       .%%%%  
                 ///*#,    %%%.%%%%%%%%%%%%%%%%%            %%%        %%%%  
               .(((###(  #%##%%#%%#                         %%%%.     %%%%   
             #(##((#####(         .                         %%%%%%%%%%%%*    
                                                            /%               